###################
#$.......#....$...#
#.##.###.#.###$##.#
#.............$...#
#.##.#.#####.#.##.#
#....#...#...#....#
####.###.#.###.####
####.#...$...#.####
####.#.##$##.#.####
$$$$...#$$$#...$$$$
####$#.#####.#.####
####$#.......#.####
####$#.#####.#.####
#........#........#
#.##.###.#.###.##.#
#..#...........#..#
##.#.#.#####.#.#.##
#....#...#...#....#
#.######.#.######.#
#............$$$..#
###################
